--------------------
--------------------
--------------------
-------#######------
---#####.....##-----
---#..........##----
---#...........##---
---#............#---
--##............#---
--#.............#---
--#............##---
--#............#----
--#............#----
--#............#----
--##...........#----
---#.....@.....#----
---#############----
--------------------
--------------------